Apollo 13 -- Houston, we have a problem
Forrest Gump -- Mama always said, life is like a box of chocolates. You never know what you are going to get.
A Few Good Men-- You cant handle the truth.
A Shot in the Dark -- I believe everything and I believe nothing
Dirty Dancing -- Nobody puts Baby in the corner.
Jerry Maguire -- Show me the money.
Casablanca -- Louis, I think this is the beginning of a beautiful friendship.
Star Wars -- May the Force be with you.
Lord of the Rings -- You shall not pass.
Dr No -- My name is Bond. James Bond
Braveheart -- They may take our lives, but they'll never take our freedom.
Finding Nemo -- Just keep swimming.
The Terminator -- I'll be back.
The Avengers -- Avengers assemble.
Matrix Reloaded -- Mr.Anderson. Surprised to see me?
Dead Poets Society -- Oh Captain, my Captain.
The Devil Wears Prada -- I am just one stomach flu away from my goal weight.
Snow White and the Huntsman -- Magic Mirror on the wall, who is the fairest one of all?
Rocky -- Yo, Adrian
The Karate Kid -- Wax on, wax off.
Transformers -- Come on, Decepticon punk.
12 Years a Slave -- I don't want to survive. I want to live.
Titanic -- I'm the king of the world!
The Silence of the Lambs -- I'm having and old frined for dinner.
Gone with the Wind -- After all, tomorrow is another day.
The Godfather -- Keep your friends close, but your enemies closer.
The Dark Night -- Why so serious?
Taxi Driver -- You talkin' to me?
The Imitation Game -- Sometimes it's the very people who no one imagines anything of who do the things no one can imagine.
The Hunger Games -- I volunteer! I volunteer! I volunteer as tribute!
